Game;ReleaseDate;Genre;LANEarnings;OnlineEarnings;TotalPlayers;TotalTournaments;AllEarnings;TierCompetitive
Dota 2;2013;Multiplayer Online Battle Arena;31187903215;28085206696;4563;1742;59273109911;1
Fortnite;2017;Battle Royale;14911647191;4584213347;6104;1149;19495860538;1
Arena of Valor;2015;Multiplayer Online Battle Arena;7039242725;6637330149;1842;145;13676572874;1
PLAYERUNKNOWN'S BATTLEGROUNDS Mobile;2017;Battle Royale;6294769628;4072285932;3423;233;10367055560;1
PLAYERUNKNOWN’S BATTLEGROUNDS;2017;Battle Royale;5233920306;3887534473;3517;554;9121454779;1
StarCraft II;2010;Strategy;3845168074;3071175811;2172;6817;6916343885;1
Overwatch;2016;First-Person Shooter;3428777088;1873273758;3836;807;5302050846;1
Rainbow Six Siege;2015;First-Person Shooter;3249940267;2433728672;2794;530;5683668939;1
Hearthstone;2014;Collectible Card Game;2945181142;1827381689;2999;1054;4772562831;1
Rocket League;2015;Sports;2690212067;990195392;3338;2828;3680407459;1
Heroes of the Storm;2015;Multiplayer Online Battle Arena;1840655468;1421423564;1296;493;3262079032;1
Apex Legends;2019;Battle Royale;1670771301;526859925;2129;709;2197631226;1
VALORANT;2020;First-Person Shooter;1552150008;629876398;4552;870;2182026406;1
Counter-Strike: Global Offensive;2012;First-Person Shooter;1458771054;9484039043;15531;6566;10942810097;1
Free Fire;2017;Battle Royale;1457203293;1077696878;1558;84;2534900171;1
Counter-Strike;2000;First-Person Shooter;1356074949;1284751975;4225;1018;2640826924;1
Call of Duty: Warzone;2020;First-Person Shooter;1086972117;136000;1225;377;1087108117;2
League of Legends;2009;Multiplayer Online Battle Arena;987811816;861022404;8717;2772;1848834220;2
SMITE;2014;Multiplayer Online Battle Arena;925011275;787283257;542;97;1712294532;2
Mobile Legends: Bang Bang;2016;Multiplayer Online Battle Arena;874244136;740081709;1348;92;1614325845;2
League of Legends: Wild Rift;2021;Multiplayer Online Battle Arena;830865647;612044803;1311;93;1442910450;2
World of WarCraft;2004;Role-Playing Game;759633761;508138891;478;168;1267772652;2
Halo 5: Guardians;2015;First-Person Shooter;716048097;678268097;248;109;1394316194;2
Call of Duty: Black Ops 4;2018;First-Person Shooter;673493895;663116195;389;82;1336610090;2
WarCraft III;2002;Strategy;619404392;526620145;675;1467;1146024537;2
Clash Royale;2016;Strategy;614334827;337463898;314;56;951798725;3
Shadowverse;2016;Collectible Card Game;550847329;537367329;248;44;1088214658;2
Clash of Clans;2012;Strategy;447102787;282710187;368;65;729812974;3
chess24;2014;Strategy;417937543;0;90;28;417937543;3
Call of Duty: Infinite Warfare;2016;First-Person Shooter;416670506;404985506;343;84;821656012;3
Chess.com;2007;Strategy;400306433;500000;831;381;400806433;3
World of Tanks;2010;Strategy;398849659;391503172;418;54;790352831;3
Call of Duty: Black Ops III;2015;First-Person Shooter;393978329;378307702;424;78;772286031;3
Brawl Stars;2018;Strategy;376637606;23533224;276;45;400170830;3
Teamfight Tactics;2019;Strategy;365167096;772878;515;55;365939974;3
Brawlhalla;2015;Fighting Game;361425783;84426404;845;642;445852187;3
Super Smash Bros. Melee;2001;Fighting Game;354215927;34475395;1930;2640;388691322;3
FIFA Online 4;2018;Sports;328571448;171625423;361;56;500196871;3
Quake Champions;2017;First-Person Shooter;328161277;240184663;295;276;568345940;3
FIFA 19;2018;Sports;324614234;323302783;303;49;647917017;3
Counter-Strike: Source;2004;First-Person Shooter;311322229;287276603;1502;333;598598832;3
Heroes of Newerth;2010;Multiplayer Online Battle Arena;308825272;172243617;820;396;481068889;3
iRacing.com;2008;Racing;306819403;6790171;1273;181;313609574;3
Age of Empires II;1999;Strategy;290890799;104053359;1825;1425;394944158;3
Naraka: Bladepoint;2021;Role-Playing Game;290813052;2473700;138;12;293286752;3
Call of Duty: Advanced Warfare;2014;First-Person Shooter;261180893;226763614;783;405;487944507;3
Tekken 7;2015;Fighting Game;240978733;214693622;580;384;455672355;3
Street Fighter V;2016;Fighting Game;226679843;221829843;279;130;448509686;3
Super Smash Bros. Ultimate;2018;Fighting Game;226418881;188017674;2318;1654;414436555;3
Street Fighter V: Arcade Edition;2018;Fighting Game;226394595;226309595;235;104;452704190;3
FIFA 21;2020;Sports;224513453;8414013;234;26;232927466;3
FIFA 18;2017;Sports;223369769;222126708;235;48;445496477;3
rFactor 2;2013;Racing;214676312;144169694;548;101;358846006;3
FIFA Online 3;2012;Sports;193754285;193754285;124;25;387508570;3
StarCraft: Remastered;2017;Strategy;187077979;141416677;276;247;328494656;3
Point Blank;2008;First-Person Shooter;173562124;157748306;556;105;331310430;3
Halo 2;2004;First-Person Shooter;162676247;148936247;126;74;311612494;3
Call of Duty: Ghosts;2013;First-Person Shooter;159418525;150447289;199;76;309865814;3
CrossFire;2007;First-Person Shooter;158115578;1507633151;841;336;1665748729;2
Minecraft;2011;Multiplayer Online Battle Arena;155422715;104000;486;75;155526715;3
Super Smash Bros. for Wii U;2014;Fighting Game;151545147;151281647;1280;1035;302826794;3
FIFA 17;2016;Sports;148261263;148261263;156;48;296522526;3
Call of Duty: Black Ops 2;2012;First-Person Shooter;147913925;143007163;187;54;290921088;3
WarCraft III: Reforged;2020;Strategy;144630502;45614384;139;335;190244886;3
Gwent;2016;Collectible Card Game;139099717;75539117;343;120;214638834;3
Lichess;2010;Strategy;128732991;0;346;164;128732991;3
Identity V;2018;Strategy;118952681;72609148;30;4;191561829;3
Quake III Arena;1999;First-Person Shooter;116534621;114753418;288;109;231288039;3
Auto Chess;2019;Strategy;116372028;103822228;133;52;220194256;3
Call of Duty: Modern Warfare 3;2011;First-Person Shooter;116081566;114495566;209;45;230577132;3
Vainglory;2014;Multiplayer Online Battle Arena;90642119;80582587;262;36;171224706;3
Street Fighter V: Champion Edition;2020;Fighting Game;89104067;35055821;263;148;124159888;3
Defense of the Ancients;2003;Multiplayer Online Battle Arena;85742065;82965868;468;94;168707933;3
Injustice 2;2017;Fighting Game;83744716;83601457;81;38;167346173;3
Ultra Street Fighter IV;2014;Fighting Game;81839462;81835462;242;233;163674924;3
Age of Empires IV;2021;Strategy;81678568;40843841;411;247;122522409;3
Halo: Reach;2010;First-Person Shooter;77208997;71208997;121;29;148417994;3
Call of Duty: Modern Warfare;2019;First-Person Shooter;75007845;6785625;393;81;81793470;4
StarCraft: Brood War;1998;Strategy;73087921;70765606;621;499;143853527;3
Team Fortress 2;2007;First-Person Shooter;72849134;40175973;1367;199;113025107;3
Quake Live;2010;First-Person Shooter;68497912;59997293;225;413;128495205;3
Blade & Soul;2012;Role-Playing Game;67900626;67900626;89;7;135801252;3
Call of Duty: Blackout;2018;First-Person Shooter;61160835;32100835;175;18;93261670;4
Farming Simulator 19;2018;Strategy;58226788;17188981;127;25;75415769;4
Mortal Kombat 11;2019;Fighting Game;57639054;49412834;233;60;107051888;3
KartRider;2004;Racing;56736635;56736635;76;20;113473270;3
Mortal Kombat X;2015;Fighting Game;56353242;56353242;100;62;112706484;3
Quake 4;2005;First-Person Shooter;55853927;55628851;103;54;111482778;3
F1 2019;2019;Racing;53804738;53804738;25;2;107609476;3
Legends of Runeterra;2020;Collectible Card Game;52618103;0;70;9;52618103;4
Pro Evolution Soccer 2017;2016;Sports;51469771;51469771;39;16;102939542;3
TEPPEN;2019;Strategy;50472147;45672147;18;2;96144294;4
Multigaming;2000;Strategy;50076646;50076646;36;8;100153292;3
Dead or Alive 4;2005;Fighting Game;49774531;49774531;45;13;99549062;4
Halo 2 Anniversary;2014;First-Person Shooter;46870505;46870505;97;20;93741010;4
FIFA 13;2012;Sports;45842782;44819559;53;62;90662341;4
Age of Empires;1997;Strategy;44428571;32193622;396;219;76622193;4
Halo 4;2012;First-Person Shooter;43074876;42849876;66;19;85924752;4
Call of Duty 4: Modern Warfare;2007;First-Person Shooter;42540927;39300711;431;87;81841638;4
Madden NFL 2018;2017;Sports;42367662;2067662;40;3;44435324;4
Dragon Ball FighterZ;2018;Fighting Game;42190314;39900664;270;163;82090978;4
Call of Duty: Black Ops;2010;First-Person Shooter;37579348;34696918;118;23;72276266;4
Super Street Fighter IV Arcade Edition;2010;Fighting Game;35558667;35558667;154;204;71117334;4
Fall Guys;2020;Battle Royale;34027383;0;250;7;34027383;4
CrossFire Mobile;2015;First-Person Shooter;32824175;32824175;0;12;65648350;4
Project Gotham Racing 3;2005;Racing;29728685;29728685;33;10;59457370;4
World in Conflict;2007;Strategy;29333823;29333823;38;11;58667646;4
Diabotical;2020;First-Person Shooter;26231497;2316846;390;382;28548343;4
ShootMania Storm;2013;First-Person Shooter;26209069;2582865;108;43;28791934;4
FIFA 20;2019;Sports;26066671;114115877;322;63;140182548;3
Doom 3;2004;First-Person Shooter;25774816;25774816;14;4;51549632;4
Gears of War;2006;Third-Person Shooter;25219557;25219557;33;18;50439114;4
FIFA 23;2022;Sports;25045111;250000;43;2;25295111;4
Paladins;2015;First-Person Shooter;24905076;1789000;576;79;26694076;4
Super Smash Bros. Brawl;2008;Fighting Game;24810083;24810083;509;348;49620166;4
Battlefield 4;2013;First-Person Shooter;24576646;21254031;204;145;45830677;4
FIFA 07;2006;Sports;23831223;23831223;43;14;47662446;4
Halo 3;2007;First-Person Shooter;23180794;21614794;214;43;44795588;4
Killer Instinct (2013);2013;Fighting Game;22632354;22625354;132;57;45257708;4
Guilty Gear -STRIVE-;2021;Fighting Game;21773288;13848956;221;64;35622244;4
FIFA 08;2007;Sports;20712994;20712994;68;17;41425988;4
Battalion 1944;2018;First-Person Shooter;20665467;12986388;135;29;33651855;4
Project M;2010;Fighting Game;20529209;20529209;560;335;41058418;4
TrackMania 2: Stadium;2013;Racing;20064487;10945291;345;287;31009778;4
Echo Arena;2017;Sports;19373232;16936232;126;22;36309464;4
Granblue Fantasy: Versus;2020;Fighting Game;18682588;15275477;118;84;33958065;4
osu!;2007;Music / Rhythm Game;18353302;1027139;1574;138;19380441;4
Soul Calibur VI;2018;Fighting Game;17668727;15901328;127;71;33570055;4
Rainbow Six: Vegas;2006;First-Person Shooter;17640077;17640077;106;7;35280154;4
TrackMania Nations Forever;2008;Racing;17133147;14655475;132;76;31788622;4
Ultimate Marvel vs. Capcom 3;2011;Fighting Game;14767959;14555224;209;185;29323183;4
S.K.I.L.L. - Special Force 2;2013;First-Person Shooter;14753293;13155581;97;22;27908874;4
Unreal Tournament 2003;2002;First-Person Shooter;14747391;14747391;33;14;29494782;4
FIFA 15;2014;Sports;14437399;11643915;168;352;26081314;4
Wolfenstein: Enemy Territory;2003;First-Person Shooter;14096324;13837687;152;18;27934011;4
Quake II;1997;First-Person Shooter;14042598;139800;34;12;14182398;4
FIFA 22;2021;Sports;13884115;13851943;160;10;27736058;4
Mortal Kombat 9;2011;Fighting Game;13689167;13689167;67;26;27378334;4
Mortal Kombat XL;2016;Fighting Game;13420379;12920379;55;18;26340758;4
Unreal Tournament 2004;2004;First-Person Shooter;13396933;13396933;41;12;26793866;4
Call of Duty: Warzone 2.0;2022;First-Person Shooter;13178878;0;62;12;13178878;4
Evolve;2015;First-Person Shooter;13150905;1260541;110;33;14411446;4
FIFA 09;2008;Sports;12161834;11532142;52;19;23693976;4
Tekken 6;2007;Fighting Game;11987464;11987464;59;30;23974928;4
Artifact Classic;2018;Collectible Card Game;11958434;1163581;276;172;13122015;4
FIFA 16;2015;Sports;11782811;11688394;61;28;23471205;4
Call of Duty: Modern Warfare 2;2009;First-Person Shooter;11736064;5101064;65;20;16837128;4
FIFA 10;2009;Sports;11702671;9014721;64;48;20717392;4
Age of Mythology;2002;Strategy;11605582;5311482;180;191;16917064;4
Age of Empires III;2005;Strategy;11389365;41800;164;141;11431165;4
FIFA 06;2005;Sports;11246453;11246453;23;12;22492906;4
Unreal Tournament 3;2007;First-Person Shooter;10497782;10497782;7;4;20995564;4
QuakeWorld;1996;First-Person Shooter;10385167;9800544;49;18;20185711;4
TrackMania Nations;2006;Racing;10138166;6138166;22;8;16276332;4
Magic: The Gathering Arena;2018;Collectible Card Game;10088000;5854000;323;52;15942000;4
FIFA 14;2013;Sports;9634781;8737748;57;69;18372529;4
FIFA 11;2010;Sports;9398377;8515402;72;78;17913779;4
Battlefield 2;2005;First-Person Shooter;9171522;9171522;0;12;18343044;4
Onmyoji Arena;2018;Multiplayer Online Battle Arena;8967922;8967922;5;1;17935844;4
BlazBlue: Central Fiction;2015;Fighting Game;8827321;8797637;106;47;17624958;4
Street Fighter X Tekken;2012;Fighting Game;8409064;8322934;115;93;16731998;4
Samurai Shodown (2019);2019;Fighting Game;7798331;7785831;75;20;15584162;4
Pokkén Tournament;2016;Fighting Game;7721666;7697166;65;26;15418832;4
Marvel vs. Capcom: Infinite;2017;Fighting Game;7625672;7620212;60;22;15245884;4
Assetto Corsa;2014;Racing;7496577;44144035;287;122;51640612;4
King of Fighters XIV;2016;Fighting Game;7440209;7354209;89;39;14794418;4
King of Fighters XV;2022;Fighting Game;7418951;4750609;135;27;12169560;4
Project Cars;2015;Racing;6895521;1060271;53;127;7955792;5
Super Smash Bros.;1999;Fighting Game;6883281;6869281;238;126;13752562;4
Call of Duty 2;2005;First-Person Shooter;6682851;6087471;41;17;12770322;4
Zwift;2015;Sports;6537076;0;10;7;6537076;5
Battlerite;2016;Multiplayer Online Battle Arena;6517345;28000;86;75;6545345;5
Dead or Alive 6;2019;Fighting Game;6474254;6363254;67;21;12837508;4
Call of Duty: Vanguard;2021;First-Person Shooter;6321000;5080000;261;91;11401000;4
Call of Duty: Black Ops Cold War;2020;First-Person Shooter;6299000;3500000;274;89;9799000;5
Gran Turismo Sport;2017;Racing;6152256;27511;126;25;6179767;5
Enemy Territory: Quake Wars;2007;First-Person Shooter;6092312;6092312;27;4;12184624;4
Soul Calibur V;2012;Fighting Game;6042854;6042854;79;27;12085708;4
FIFA 05;2004;Sports;5772801;5772801;5;8;11545602;4
Call of Duty: Mobile;2019;First-Person Shooter;5758274;3486274;284;15;9244548;5
Skullgirls 2nd Encore;2015;Fighting Game;5564302;22081;73;24;5586383;5
Overwatch 2;2022;First-Person Shooter;5516513;3006960;478;26;8523473;5
Call of Duty;2003;First-Person Shooter;5479977;5479977;66;4;10959954;4
Under Night In-Birth EXE: Late[st];2015;Fighting Game;5458333;5458333;109;40;10916666;4
FIFA 12;2011;Sports;5443152;4727942;53;66;10171094;4
Street Fighter III: 3rd Strike;1999;Fighting Game;5434118;5264396;108;45;10698514;4
FIFA 03;2002;Sports;5406644;5406644;10;3;10813288;4
Command & Conquer 3;2007;Strategy;5308667;5308667;9;8;10617334;4
Day of Defeat;2003;First-Person Shooter;5118041;5118041;43;4;10236082;4
Assetto Corsa Competizione;2018;Racing;5057548;3106075;469;54;8163623;5
Yu-Gi-Oh! Duel Links;2016;Collectible Card Game;4874672;0;328;219;4874672;5
Guild Wars 2;2012;Role-Playing Game;4760055;350000;152;57;5110055;5
Uncharted 4: A Thief's End;2016;First-Person Shooter;4623507;4623507;5;1;9247014;5
Call of Duty: WWII;2017;First-Person Shooter;4578021;4498605;296;77;9076626;5
Old School Runescape;2013;Role-Playing Game;4575042;28500;84;26;4603542;5
King of Fighters XIII;2010;Fighting Game;4544428;4544428;107;43;9088856;5
Tetris;1989;Puzzle Game;4251599;1663317;67;28;5914916;5
Bloodline Champions;2011;Multiplayer Online Battle Arena;4190532;40850;43;12;4231382;5
Counter-Strike Online;2016;First-Person Shooter;4069896;4069896;70;12;8139792;5
Pro Evolution Soccer 4;2004;Sports;4055064;4055064;11;2;8110128;5
Rivals of Aether;2015;Fighting Game;4031485;3778323;57;23;7809808;5
Marvel vs. Capcom 2;2000;Fighting Game;3927973;3926973;68;29;7854946;5
The Unspoken;2018;Fighting Game;3882408;3882408;7;4;7764816;5
Guilty Gear Xrd -SIGN-;2014;Fighting Game;3744566;3744566;80;38;7489132;5
BlazBlue: Chronophantasma;2012;Fighting Game;3702058;3702058;63;15;7404116;5
Guilty Gear Xrd -REVELATOR-;2016;Fighting Game;3643743;3643743;61;19;7287486;5
Need for Speed Carbon;2006;Racing;3632258;3632258;12;4;7264516;5
Trackmania (2020);2020;Racing;3577008;7315602;550;441;10892610;4
Need for Speed: Most Wanted;2005;Racing;3569454;3569454;18;7;7138908;5
Need for Speed: Underground 2;2004;Racing;3562948;3562948;8;3;7125896;5
Injustice: Gods Among Us;2013;Fighting Game;3517689;3517689;101;117;7035378;5
After-H;2019;First-Person Shooter;3292478;3292478;51;3;6584956;5
Playchess.com;2002;Strategy;3286658;0;116;9;3286658;5
Need for Speed: ProStreet;2007;Racing;3220846;3220846;12;3;6441692;5
Gears of War 4;2016;Third-Person Shooter;3142785;3055000;155;152;6197785;5
Halo Infinite;2021;First-Person Shooter;2973155;2510800;200;34;5483955;5
Pro Evolution Soccer 2014;2013;Sports;2941025;2941025;4;1;5882050;5
RaceRoom Racing Experience;2013;Racing;2775912;825837;159;27;3601749;5
Pro Evolution Soccer 2016;2015;Sports;2724384;2724384;17;6;5448768;5
DNF Duel;2022;Fighting Game;2709548;2609548;48;10;5319096;5
Pro Evolution Soccer 2015;2014;Sports;2654476;2654476;3;1;5308952;5
Dota Underlords;2019;Strategy;2602418;0;62;36;2602418;5
Super Street Fighter II Turbo;1994;Fighting Game;2564629;2564629;114;51;5129258;5
Battlefield 3;2011;First-Person Shooter;2540746;2540746;5;7;5081492;5
Project Gotham Racing 4;2007;Racing;2520846;2520846;5;4;5041692;5
Capcom vs. SNK 2;2001;Fighting Game;2497679;2497679;38;22;4995358;5
BlazBlue: Continuum Shift II;2010;Fighting Game;2459101;2459101;14;5;4918202;5
Gears 5;2019;Third-Person Shooter;2320920;680000;163;112;3000920;5
NHL 19;2018;Sports;2256667;1956667;10;8;4213334;5
TrackMania 2: Canyon;2011;Racing;2242612;1688642;24;37;3931254;5
Marvel vs. Capcom 3;2011;Fighting Game;2234362;2234362;38;12;4468724;5
ARMS;2017;Fighting Game;2215646;1392693;126;105;3608339;5
H1Z1;2016;Battle Royale;2067122;2067122;119;13;4134244;5
Persona 4 Arena Ultimax;2013;Fighting Game;2026816;2026816;65;21;4053632;5
Pro Evolution Soccer 6;2006;Sports;2021682;2021682;5;2;4043364;5
Battlefield 2142;2006;First-Person Shooter;1854614;1854614;0;4;3709228;5
Blaston;2020;First-Person Shooter;1748356;0;26;18;1748356;5
Vampire Savior;1997;Fighting Game;1664238;1549517;37;22;3213755;5
Counter-Strike: Condition Zero;2004;First-Person Shooter;1621506;1621506;111;3;3243012;5
Beat Saber;2019;Music / Rhythm Game;1617556;0;58;10;1617556;5
Dead or Alive 5: Last Round;2015;Fighting Game;1541382;1541382;46;20;3082764;5
rFactor;2005;Racing;1508356;0;51;4;1508356;5
Xonotic;2010;First-Person Shooter;1493501;2607;124;44;1496108;5
Guilty Gear XX Accent Core Plus R;2012;Fighting Game;1470214;6430;82;30;1476644;5
Day of Defeat: Source;2005;First-Person Shooter;1406857;1028647;50;8;2435504;5
Battlefield Hardline;2015;First-Person Shooter;1346328;1346328;20;1;2692656;5
Melty Blood: Type Lumina;2021;Fighting Game;1284249;1284249;44;11;2568498;5
Critical Ops;2015;First-Person Shooter;1260641;2500;4;3;1263141;5
Guilty Gear Xrd REV 2;2017;Fighting Game;1248993;1247043;125;60;2496036;5
Heavy Metal Machines;2017;Multiplayer Online Battle Arena;1233933;0;35;1;1233933;5
Magic: The Gathering Online;2002;Collectible Card Game;1218000;1218000;130;10;2436000;5
Tekken Tag Tournament 2;2011;Fighting Game;1185013;1185013;151;140;2370026;5
Live for Speed;2003;Racing;1183314;921914;28;10;2105228;5
Melty Blood: Actress Again Current Code;2010;Fighting Game;1142993;8665;68;24;1151658;5
MultiVersus;2022;Fighting Game;1142025;1001515;59;10;2143540;5
Crysis;2007;First-Person Shooter;1134095;1134095;0;2;2268190;5
Painkiller;2004;First-Person Shooter;1015000;1015000;48;13;2030000;5
Madden NFL 2017;2016;Sports;1004000;1004000;42;5;2008000;5
Turbo Racing League;2013;Racing;1000000;500000;16;9;1500000;5
Madden NFL 22;2021;Sports;1000000;1000000;14;1;2000000;5
NBA 2K18;2017;Sports;1000000;1000000;91;4;2000000;5
BlazBlue: Cross Tag Battle;2018;Fighting Game;978727;9562431;128;42;10541158;4
Hand of the Gods;2017;Collectible Card Game;944342;72500;48;36;1016842;5
Madden NFL 20;2019;Sports;923000;703000;38;2;1626000;5
Company of Heroes 2;2013;Strategy;856122;795622;11;6;1651744;5
Black Squad;2017;First-Person Shooter;848072;0;57;17;848072;5
Forza Motorsport 7;2017;Racing;820200;616200;123;12;1436400;5
Age of Empires Online;2011;Strategy;799656;775;38;39;800431;5
Warhammer 40,000: Dawn of War;2005;Strategy;798165;798165;7;3;1596330;5
King of Fighters 98;1998;Fighting Game;794557;794557;7;3;1589114;5
Street Fighter IV;2009;Fighting Game;793822;793822;41;12;1587644;5
Star Wars Jedi Knight II: Jedi Outcast;2002;First-Person Shooter;767925;767925;0;1;1535850;5
NASCAR Thunder 2002;2001;Racing;767925;767925;0;1;1535850;5
F1 2021;2021;Racing;765939;0;35;4;765939;5
F1 2020;2020;Racing;752235;0;42;3;752235;5
F1 22;2022;Racing;750324;0;25;2;750324;5
Gears of War 3;2011;Third-Person Shooter;725581;455581;13;4;1181162;5
Return to Castle Wolfenstein;2001;First-Person Shooter;674243;674243;30;3;1348486;5
Summoners War: Sky Arena;2014;Strategy;652000;372000;32;6;1024000;5
Under Night In-Birth Exe:Late[cl-r];2020;Fighting Game;633701;570725;38;9;1204426;5
Persona 4 Arena;2012;Fighting Game;633663;633663;42;11;1267326;5
Hearthstone Battlegrounds;2019;Collectible Card Game;603630;300000;79;7;903630;5
Under Night In-Birth EXE: Late;2014;Fighting Game;602576;602576;52;23;1205152;5
Windjammers;1994;Strategy;565147;516216;36;16;1081363;5
Lethal League Blaze;2018;Fighting Game;564392;167775;25;12;732167;5
Call of Duty: Modern Warfare II;2022;First-Person Shooter;563000;500000;59;4;1063000;5
Tetr.io;2020;Puzzle Game;528788;20344;27;13;549132;5
Tower Tag;2020;First-Person Shooter;517041;0;25;5;517041;5
Doom II: Hell on Earth;1994;First-Person Shooter;510856;2200;14;8;513056;5
Unreal Tournament (2016);2016;First-Person Shooter;508497;0;82;8;508497;5
Mario Kart 8 Deluxe;2017;Racing;500444;500444;48;9;1000888;5
eFootball;2021;Sports;492000;25000;62;14;517000;5
BlazBlue: Chronophantasma Extend;2015;Fighting Game;491877;491877;28;11;983754;5
Supreme Commander;2007;Strategy;490126;490126;0;1;980252;5
S.T.A.L.K.E.R.: Shadow of Chernobyl;2007;First-Person Shooter;490126;490126;0;1;980252;5
Them's Fightin' Herds;2018;Fighting Game;457819;530;28;29;458349;5
Touhou Hisoutensoku ~ Choudokyuu Ginyoru no Nazo o Oe;2009;Fighting Game;450152;220;18;6;450372;5
CrossFire HD;2022;First-Person Shooter;432765;432765;56;2;865530;5
Power Rangers: Legacy Wars;2017;Fighting Game;417855;417855;2;1;835710;5
Rushdown Revolt;2021;Fighting Game;416009;0;31;18;416009;5
Madden NFL 2013;2012;Sports;400000;400000;8;1;800000;5
NHL '94;1993;Sports;381856;381856;25;8;763712;5
Puyo Puyo Tetris;2014;Puzzle Game;342284;161775;31;16;504059;5
Sailor Moon S;1995;Fighting Game;328119;327119;20;12;655238;5
NHL 15;2014;Sports;315716;315716;3;3;631432;5
NHL 14;2013;Sports;302396;302396;6;3;604792;5
Super Street Fighter IV;2010;Fighting Game;302293;208773;43;18;511066;5
Halo: Combat Evolved;2001;First-Person Shooter;299281;299281;118;39;598562;5
Hyper Scape;2020;Multiplayer Online Battle Arena;299000;0;260;4;299000;5
Street Fighter Alpha 2;1996;Fighting Game;294469;1830;24;11;296299;5
Tatsunoko vs. Capcom: Ultimate All-Stars;2010;Fighting Game;277176;133081;16;16;410257;5
Pokémon VGC;2017;Strategy;271102;271000;217;31;542102;5
Realm Royale;2018;First-Person Shooter;263000;0;47;9;263000;5
Aim Gods;2020;First-Person Shooter;250000;0;2;1;250000;5
Pro Evolution Soccer 2018;2017;Sports;250000;250000;20;3;500000;5
Reflex;2015;First-Person Shooter;245837;16366;24;9;262203;5
Forza Motorsport 2;2007;Racing;222000;222000;17;2;444000;5
Pokkén Tournament DX;2017;Fighting Game;221254;21914;44;28;243168;5
Pro Evolution Soccer 2019;2019;Sports;216000;216000;25;2;432000;5
Gran Turismo 7;2022;Sports;210848;0;13;3;210848;5
Pro Evolution Soccer 2008;2007;Sports;208415;208415;6;3;416830;5
NASCAR Heat 4;2019;Racing;200500;0;34;5;200500;5
F1 2018;2018;Racing;200000;200000;21;1;400000;5
Guns of Boom;2017;First-Person Shooter;198750;190000;8;21;388750;5
Tetris Effect: Connected;2020;Puzzle Game;193491;155288;12;3;348779;5
F.E.A.R.;2005;First-Person Shooter;178000;178000;20;5;356000;5
Forza Motorsport 6;2015;Racing;172600;170200;43;9;342800;5
Gears of War: Ultimate Edition;2015;Third-Person Shooter;170000;170000;39;3;340000;5
Fighting EX Layer;2018;Fighting Game;164296;163296;16;7;327592;5
Onward;2016;First-Person Shooter;161820;123000;92;8;284820;5
Pokemon Unite;2021;Multiplayer Online Battle Arena;150000;0;97;4;150000;5
Super People;2022;Battle Royale;144526;0;95;11;144526;5
MechWarrior Online;2013;First-Person Shooter;143490;143490;0;1;286980;5
Pro Evolution Soccer 2009;2008;Sports;139597;0;5;2;139597;5
Gears of War 2;2008;Third-Person Shooter;135000;135000;0;5;270000;5
Special Force;2004;First-Person Shooter;130250;130250;0;3;260500;5
Supreme Commander: Forged Alliance;2007;Strategy;129001;129001;0;1;258002;5
Madden NFL 19;2018;Sports;125000;125000;5;3;250000;5
Radical Heights;2018;Battle Royale;120000;0;12;2;120000;5
Escape from Tarkov;2020;First-Person Shooter;114600;0;150;4;114600;5
Warface;2013;First-Person Shooter;109555;109555;32;2;219110;5
Attack on Titan Tribute Game;2013;Fighting Game;108650;0;21;15;108650;5
Windjammers 2;2022;Fighting Game;105607;105607;3;56;211214;5
Shards of War;2015;Multiplayer Online Battle Arena;102921;0;20;1;102921;5
NHL 18;2017;Sports;102700;90000;20;6;192700;5
Sea of Thieves;2016;Strategy;100000;0;67;4;100000;5
Zula;2015;First-Person Shooter;100000;100000;20;1;200000;5
Creative Destruction;2018;Multiplayer Online Battle Arena;100000;0;8;1;100000;5
Madden NFL 2006;2005;Sports;100000;100000;1;1;200000;5
Madden NFL 2007;2006;Sports;100000;100000;1;1;200000;5
Madden NFL 2008;2007;Sports;100000;100000;1;1;200000;5
Madden NFL 2009;2008;Sports;100000;100000;1;1;200000;5
Rocket Arena;2020;Battle Royale;100000;0;24;3;100000;5
Stardew Valley;2016;Role-Playing Game;97850;0;69;3;97850;5
Soul Calibur II HD Online;2013;Fighting Game;94541;94541;29;5;189082;5
Skullgirls Encore;2014;Fighting Game;91554;91554;37;13;183108;5
Puyo Puyo Tetris 2;2020;Puzzle Game;89602;78585;10;2;168187;5
Unreal Tournament;1999;First-Person Shooter;89000;89000;14;5;178000;5
Among Us;2018;Strategy;86000;0;14;8;86000;5
Rainbow Six: Vegas 2;2008;First-Person Shooter;79000;79000;0;8;158000;5
Trackmania 2: Valley;2013;Racing;77934;77934;6;2;155868;5
Big Buck Hunter Arcade;2016;First-Person Shooter;76200;76200;3;1;152400;5
Pokémon GO;2016;Strategy;73340;71450;68;12;144790;5
NHL 12;2011;Sports;70293;70293;6;2;140586;5
NHL 13;2012;Sports;70000;70000;1;1;140000;5
Ring of Elysium;2018;Battle Royale;70000;0;9;4;70000;5
Rise of Nations: Rise of Legends;2006;Strategy;69600;69600;8;1;139200;5
Trackmania Turbo;2016;Racing;67941;0;6;2;67941;5
Power Rangers: Battle for the Grid;2019;Fighting Game;67468;30862;26;12;98330;5
Project Cars 2;2017;Racing;66150;58150;37;22;124300;5
Garou: Mark of the Wolves;1999;Fighting Game;65871;51371;13;4;117242;5
World of Tanks Blitz;2016;Strategy;63330;60000;14;6;123330;5
Fight of Animals;2019;Fighting Game;63068;0;9;4;63068;5
Carom 3D;1999;Sports;60500;60500;11;4;121000;5
Dead By Daylight;2016;Strategy;60000;0;35;9;60000;5
NASCAR Thunder 2003;2002;Racing;59335;59335;0;1;118670;5
Samurai Shodown V Special;2004;Fighting Game;59057;49011;15;5;108068;5
Red Stone;2004;Role-Playing Game;58000;58000;12;2;116000;5
Fantasy Strike;2019;Fighting Game;57998;2610;21;5;60608;5
Virtua Fighter 5 Final Showdown;2010;Fighting Game;57377;57377;28;6;114754;5
DOOMBRINGER;2017;First-Person Shooter;56777;0;8;4;56777;5
Asphalt 9: Legends;2018;Racing;51520;51520;5;2;103040;5
Rezzil Player;2021;Sports;51250;0;15;10;51250;5
Resistance 2;2008;First-Person Shooter;50400;0;194;1;50400;5
Borderlands 3;2019;First-Person Shooter;50000;0;16;1;50000;5
Descent 3;1999;First-Person Shooter;50000;50000;1;1;100000;5
Splitgate: Arena Warfare;2019;Multiplayer Online Battle Arena;50000;0;64;2;50000;5
WWE 2K20;2019;Fighting Game;50000;0;20;2;50000;5
FIFA 2000;1999;Sports;50000;50000;4;1;100000;5
Madden NFL 2016;2015;Sports;50000;50000;8;1;100000;5
Spellbreak;2020;Battle Royale;50000;0;42;1;50000;5
Rogue Company;2020;Third-Person Shooter;50000;0;48;2;50000;5
Legend of Glory;2015;Multiplayer Online Battle Arena;47266;0;0;1;47266;5
Echo Combat;2018;First-Person Shooter;46800;46800;16;1;93600;5
FIFA 2001;2000;Sports;46000;46000;9;2;92000;5
Crab Game;2021;Multiplayer Online Battle Arena;45950;44000;32;11;89950;5
Pocket Bravery;2022;Fighting Game;45235;45235;3;1;90470;5
Gran Turismo 4;2004;Racing;44000;44000;5;2;88000;5
FIFA 2002 World Cup;2002;Sports;43000;43000;8;1;86000;5
Aliens versus Predator 2;2001;First-Person Shooter;40000;40000;1;1;80000;5
FIFA 04;2003;Sports;40000;40000;3;3;80000;5
Virtua Fighter 5;2007;Fighting Game;39830;39830;14;7;79660;5
Dengeki Bunko: Fighting Climax Ignition;2015;Fighting Game;38528;36673;40;14;75201;5
Grey Goo;2015;Strategy;36400;30400;18;5;66800;5
VAIL VR;2022;First-Person Shooter;36000;35000;30;2;71000;5
Need for Speed: Underground;2003;Racing;35000;35000;3;1;70000;5
Project Gotham Racing 2;2003;Racing;35000;35000;4;2;70000;5
JoJo's Bizarre Adventure: Heritage for the Future;1999;Fighting Game;32499;0;8;3;32499;5
Pro Evolution Soccer 5;2005;Sports;32000;32000;4;1;64000;5
Space Junkies;2019;First-Person Shooter;30420;24600;33;4;55020;5
UNO;2016;Strategy;30000;0;28;3;30000;5
Dead or Alive Ultimate;2004;Fighting Game;30000;30000;3;1;60000;5
Dirt Rally 2.0;2019;Racing;30000;10000;9;4;40000;5
Smash Remix;2019;Fighting Game;29906;0;4;1;29906;5
Asphalt 4;2008;Racing;29500;29500;5;2;59000;5
The Division 2;2019;Third-Person Shooter;27250;0;40;2;27250;5
WRC 10 FIA World Rally Championship;2021;Racing;25250;25250;1;1;50500;5
Pro Evolution Soccer 3;2003;Sports;25000;25000;8;2;50000;5
Puyo Puyo Champions;2019;Puzzle Game;24823;20718;14;5;45541;5
Ghost Recon Advanced Warfighter;2006;First-Person Shooter;24000;24000;0;2;48000;5
Shadowrun;2007;First-Person Shooter;24000;24000;0;3;48000;5
Kirby Fighters 2;2020;Fighting Game;22286;0;4;1;22286;5
GRID (2019);2019;Racing;21875;21875;3;1;43750;5
Dragon Ball Z: Budokai 3;2004;Fighting Game;20406;20406;3;1;40812;5
Mad Skills Motocross 2;2017;Racing;20163;20163;12;1;40326;5
Sekiro: Shadows Die Twice;2019;Fighting Game;19596;0;20;1;19596;5
Golf With Your Friends;2016;Sports;19400;0;11;2;19400;5
Cultris II;2011;Puzzle Game;19095;0;3;1;19095;5
Guitar Hero III: Legends of Rock;2007;Sports;19000;19000;8;2;38000;5
Mordhau;2019;Fighting Game;16623;0;40;3;16623;5
Super Street Fighter II Turbo HD Remix;2008;Fighting Game;16360;16360;29;8;32720;5
Lemnis Gate;2021;First-Person Shooter;15647;0;6;5;15647;5
The Binding of Isaac;2011;Strategy;15000;0;16;1;15000;5
Forza Motorsport 4;2011;Racing;13237;13237;2;1;26474;5
Eternal Fighter Zero;2000;Fighting Game;13116;0;7;2;13116;5
Prophecy;2020;Strategy;13000;0;27;4;13000;5
Tekken 4;2001;Fighting Game;12500;12500;4;4;25000;5
Tekken 5: Dark Resurrection;2006;Fighting Game;12180;12180;18;5;24360;5
Wise Star 2;2008;Puzzle Game;12000;12000;3;1;24000;5
Sprint Vector;2018;Racing;11750;11750;8;1;23500;5
Artifact Foundry;2020;Collectible Card Game;11745;0;21;12;11745;5
Forza Motorsport 3;2009;Racing;11000;11000;3;2;22000;5
Mystery Game Tournament;2019;Fighting Game;10995;10995;56;8;21990;5
Need for Speed: Shift;2009;Racing;10500;10500;3;1;21000;5
Guitar Hero 5;2009;Sports;10500;10500;3;1;21000;5
Guilty Gear XX Accent Core;2007;Fighting Game;10365;10365;33;4;20730;5
Trackmania United;2006;Racing;10275;10275;3;1;20550;5
Guilty Gear XX Slash;2005;Fighting Game;10250;10250;6;2;20500;5
Hyper Street Fighter II;2003;Fighting Game;10250;10250;8;1;20500;5
Tekken 5;2004;Fighting Game;10250;10250;10;9;20500;5
Splatoon 2;2017;First-Person Shooter;10055;9755;13;7;19810;5
Dead by Daylight Mobile;2020;Strategy;10000;0;0;1;10000;5
Internet Chess Club;1995;Strategy;10000;0;6;1;10000;5
Zombieland VR: Headshot Fever;2021;First-Person Shooter;10000;0;4;1;10000;5
Metal Gear Online;2008;First-Person Shooter;8000;0;37;8;8000;5
Million Arthur: Arcana Blood;2017;Fighting Game;7540;7530;12;4;15070;5
Pistol Whip;2019;First-Person Shooter;7500;0;13;1;7500;5
Doom (2016);2016;First-Person Shooter;7000;7000;6;1;14000;5
Nascar Heat 5;2020;Racing;6125;2500;20;2;8625;5
Divekick;2013;Fighting Game;5840;5840;27;11;11680;5
Archangel Hellfire;2017;First-Person Shooter;5500;2000;14;9;7500;5
Rage;2011;First-Person Shooter;5000;5000;3;1;10000;5
Forza Horizon 5;2021;Racing;5000;0;7;1;5000;5
GOLF Plus;2020;Sports;5000;5000;4;1;10000;5
The Elder Scrolls: Legends;2017;Collectible Card Game;5000;5000;3;1;10000;5
Soul Calibur II;2003;Fighting Game;4980;4980;17;8;9960;5
Naruto Shippuden: Ultimate Ninja Storm 4;2016;Fighting Game;4550;2000;7;5;6550;5
Faeria;2017;Collectible Card Game;4100;0;12;5;4100;5
Nock;2022;Sports;4050;0;12;2;4050;5
Gran Turismo 3: A-Spec;2001;Racing;3250;3250;4;2;6500;5
Microsoft Excel;1985;Puzzle Game;3200;0;17;8;3200;5
Mythgard;2019;Collectible Card Game;3000;0;9;3;3000;5
Rocket League Sideswipe;2021;Sports;2500;0;1;1;2500;5
Synth Riders;2018;Sports;2100;600;11;7;2700;5
ComPet;2016;Strategy;2000;0;50;1;2000;5
Walkabout Mini Golf;2021;Sports;2000;0;7;2;2000;5
Nitroplus Blasterz: Heroines Infinite Duel;2015;Fighting Game;1994;1994;10;4;3988;5
Virtua Fighter 5: Ultimate Showdown;2021;Fighting Game;1870;870;14;3;2740;5
Koihime Enbu;2016;Fighting Game;1765;1615;14;7;3380;5
Catherine;2011;Puzzle Game;1545;1470;11;7;3015;5
Madden NFL 2004;2003;Sports;1500;1500;3;1;3000;5
Splatoon;2015;First-Person Shooter;1390;0;3;4;1390;5
Pavlov;2017;First-Person Shooter;1260;0;19;3;1260;5
Warparty;2019;Strategy;1175;0;6;2;1175;5
Loco Dojo Unleashed;2021;Strategy;1000;1000;4;1;2000;5
Contractors;2018;First-Person Shooter;1000;0;20;1;1000;5
Snapshot VR;2020;First-Person Shooter;1000;0;15;2;1000;5
Arcana Heart 3;2009;Fighting Game;1000;1000;4;1;2000;5
Ninja Legends;2019;Fighting Game;1000;0;6;1;1000;5
Rising Thunder;2015;Fighting Game;1000;1000;3;1;2000;5
SuperPlayer;2022;Sports;1000;0;3;1;1000;5
Kill la Kill the Game: IF;2019;Fighting Game;920;770;12;4;1690;5
Teenage Mutant Ninja Turtles: Tournament Fighters;1993;Fighting Game;820;820;7;2;1640;5
Star Wars: Squadrons;2020;Strategy;800;0;4;1;800;5
JoJo's Bizarre Adventure: All Star Battle R;2022;Fighting Game;780;780;8;1;1560;5
King of Fighters 2002 Unlimited Match;2009;Fighting Game;760;760;6;2;1520;5
Cave Digger 2;2021;Role-Playing Game;750;0;4;1;750;5
Duck Game;2014;Fighting Game;750;0;5;2;750;5
Audio Trip;2020;Sports;650;0;4;2;650;5
Mario Tennis Aces;2018;Sports;613;0;6;2;613;5
Slap City;2018;Fighting Game;600;0;5;2;600;5
SLAYERS FOR HIRE;2020;Fighting Game;600;0;8;2;600;5
Arcana Heart 3: Love Max Six Stars!!!!!;2014;Fighting Game;570;520;8;4;1090;5
Def Jam: Fight for NY;2004;Fighting Game;550;360;6;3;910;5
NBA 2K21;2020;Sports;501;0;3;1;501;5
Jak and Daxter: The Precursur Legacy;2001;Racing;500;0;16;1;500;5
Gym Masters VR;2021;Sports;500;0;4;1;500;5
Racket: NX;2018;Sports;500;0;3;1;500;5
Void Racer;2020;Racing;460;0;4;1;460;5
Beat Aim;2019;First-Person Shooter;430;0;12;6;430;5
SNK Heroines: Tag Team Frenzy;2018;Fighting Game;430;430;3;1;860;5
Mobile Suit Gundam: Extreme Vs Maxi Boost ON;2016;Third-Person Shooter;420;320;12;2;740;5
Acceleration of SUGURI 2;2018;Fighting Game;410;210;8;3;620;5
Arcana Heart 3: LOVE MAX!!!!!;2013;Fighting Game;410;410;6;2;820;5
Punch Planet;2017;Fighting Game;400;0;6;2;400;5
Street Fighter EX2 Plus;1999;Fighting Game;350;350;5;2;700;5
Street Fighter Alpha 3;1998;Fighting Game;340;340;16;5;680;5
Maiden & Spell;2020;Fighting Game;325;0;5;2;325;5
Ultra Fight Da! Kyanta 2;2019;Fighting Game;320;320;3;1;640;5
Skullgirls;2012;Fighting Game;300;300;3;1;600;5
Gundam Versus;2017;First-Person Shooter;280;280;6;1;560;5
Jstris;2014;Puzzle Game;275;0;12;2;275;5
Soul Calibur IV;2008;Fighting Game;260;260;3;2;520;5
Blankos Block Party;2020;Multiplayer Online Battle Arena;250;0;3;1;250;5
Aquapazza: Aquaplus Dream Match;2011;Fighting Game;245;245;5;2;490;5
MOBA Legends;2016;Multiplayer Online Battle Arena;225;0;3;1;225;5
Tetris Ultimate;2014;Puzzle Game;221;221;3;1;442;5
Super Mario Party;2018;Strategy;220;220;4;1;440;5
Digimon Rumble Arena;2001;Fighting Game;200;0;5;2;200;5
Naruto: Gekitou Ninja Taisen! 4;2005;Fighting Game;200;0;3;1;200;5
Schwarzerblitz;2020;Fighting Game;200;0;5;2;200;5
Fighter's History Dynamite;1994;Fighting Game;195;195;3;1;390;5
Project Plus;2019;Fighting Game;195;0;6;2;195;5
Umineko: Golden Fantasia;2010;Fighting Game;190;90;9;3;280;5
Pocket Rumble;2016;Fighting Game;185;0;5;2;185;5
Catherine: Full Body;2019;Puzzle Game;185;185;3;1;370;5
Warsow;2012;First-Person Shooter;183;0;2;1;183;5
Project Justice;2000;Fighting Game;165;165;3;1;330;5
Ultimate Mortal Kombat 3;1995;Fighting Game;150;150;6;2;300;5
Speedrunners;2016;Racing;150;0;5;2;150;5
Twinkle Star Sprites;1996;Puzzle Game;150;0;4;2;150;5
Hokuto no Ken;2005;Fighting Game;145;145;3;1;290;5
Capcom vs. SNK;2000;Fighting Game;140;140;6;2;280;5
Chaos Code: New Sign of Catastrophe;2013;Fighting Game;140;140;3;1;280;5
HYPERFIGHT;2019;Fighting Game;140;0;4;2;140;5
Panel Attack;2020;Puzzle Game;140;0;5;2;140;5
Magical Drop III;1997;Puzzle Game;130;130;3;1;260;5
Chex Quest;1996;First-Person Shooter;100;0;2;1;100;5
Mighty Fight Federation;2021;Fighting Game;100;0;3;1;100;5
Red Earth;1996;Fighting Game;100;0;3;1;100;5
Toribash;2006;Fighting Game;100;0;3;1;100;5
Tough Love Arena;2021;Fighting Game;100;0;3;1;100;5
Power Instinct: Matrimelee;2002;Fighting Game;90;0;5;2;90;5
Shrek SuperSlam;2005;Fighting Game;80;0;4;2;80;5
Samurai Shodown III;1995;Fighting Game;70;0;5;2;70;5
Dengeki Bunko: Fighting Climax;2014;Fighting Game;60;60;3;1;120;5
Shovel Knight Showdown;2019;Fighting Game;60;60;3;1;120;5
The Last Blade 2;1998;Fighting Game;60;0;4;2;60;5
Roof Rage;2019;Fighting Game;50;0;3;1;50;5
BlazBlue: Calamity Trigger;2008;Fighting Game;35;35;3;1;70;5
Guilty Gear;1998;Fighting Game;32;32;3;1;64;5
King of Fighters XI;2005;Fighting Game;25;25;3;1;50;5
Akatsuki Blitzkampf;2007;Fighting Game;20;0;3;1;20;5
Breakers Revenge;1998;Fighting Game;16;0;3;1;16;5
Asuka 120% LimitOver BURNING Fest.;1998;Fighting Game;10;0;3;1;10;5
Clash Royale x Chess;2022;Strategy;0;0;0;0;0;0
Endgods;2015;Strategy;0;0;0;0;0;0
Heroes of Might and Magic III;1999;Strategy;0;0;0;0;0;0
Iron Harvest;2020;Strategy;0;0;0;0;0;0
Legion TD 2;2021;Strategy;0;0;0;0;0;0
Men of War: Assault Squad 2;2014;Strategy;0;0;0;0;0;0
Warhammer 40,000: Dawn of War II;2009;Strategy;0;0;0;0;0;0
Alliance of Valiant Arms;2009;First-Person Shooter;0;0;0;0;0;0
Battlefield 1;2016;First-Person Shooter;0;0;0;0;0;0
Battlefield V;2018;First-Person Shooter;0;0;0;0;0;0
EV.IO;2021;First-Person Shooter;0;0;0;0;0;0
Ironsight;2018;First-Person Shooter;0;0;0;0;0;0
Islands of Nyne;2017;First-Person Shooter;0;0;0;0;0;0
Rainbow Six Extraction;2022;First-Person Shooter;0;0;0;0;0;0
Resistance 2;2008;First-Person Shooter;0;0;0;0;0;0
Rust;2013;First-Person Shooter;0;0;0;0;0;0
Sudden Attack;2005;First-Person Shooter;0;0;0;0;0;0
Vail VR;2022;First-Person Shooter;0;0;0;0;0;0
Zula;2015;First-Person Shooter;0;0;0;0;0;0
Dofus;2004;Multiplayer Online Battle Arena;0;0;0;0;0;0
Roblox;2006;Multiplayer Online Battle Arena;0;0;0;0;0;0
Teeworlds;2007;Multiplayer Online Battle Arena;0;0;0;0;0;0
Chivalry 2;2021;Role-Playing Game;0;0;0;0;0;0
BlazBlue: Continuum Shift Extend;2011;Fighting Game;0;0;3;1;0;0
Brawlout;2017;Fighting Game;0;0;0;0;0;0
Dead or Alive 5;2012;Fighting Game;0;0;4;2;0;0
Dead or Alive 5 Ultimate;2013;Fighting Game;0;0;37;7;0;0
Guilty Gear XX;2002;Fighting Game;0;0;5;2;0;0
Guilty Gear XX #Reload;2003;Fighting Game;0;0;3;1;0;0
Guilty Gear XX Accent Core Plus;2008;Fighting Game;0;0;3;1;0;0
Melty Blood: Actress Again;2009;Fighting Game;0;0;10;2;0;0
Mortal Kombat vs. DC Universe;2008;Fighting Game;0;0;3;1;0;0
Tekken Tag Tournament;1999;Fighting Game;0;0;7;4;0;0
TowerFall: Ascension;2013;Fighting Game;0;0;0;0;0;0
Virtua Fighter 4: Evolution;2002;Fighting Game;0;0;6;3;0;0
Epic Roller Coasters VR;2018;Racing;0;0;0;0;0;0
Hot Lap League;2021;Racing;0;0;0;0;0;0
Jak 3;2004;Racing;0;0;0;0;0;0
Jak II;2003;Racing;0;0;14;1;0;0
Marbles on Stream;2018;Racing;0;0;0;0;0;0
Trackmania United Forever;2008;Racing;0;0;0;0;0;0
Trials Fusion;2014;Racing;0;0;0;0;0;0
Dream league Soccer;2019;Sports;0;0;0;0;0;0
Eleven Table Tennis;2016;Sports;0;0;0;0;0;0
Groove Gunner;2020;Sports;0;0;0;0;0;0
Guitar Hero: World Tour;2008;Sports;0;0;0;0;0;0
Just Dance 2014;2014;Sports;0;0;3;1;0;0
Just Hoops;2021;Sports;0;0;0;0;0;0
NBA 2K Online;2012;Sports;0;0;0;0;0;0
NBA 2K19;2018;Sports;0;0;0;0;0;0
NBA 2K20;2019;Sports;0;0;0;0;0;0
NHL 17;2016;Sports;0;0;0;0;0;0
Pro Evolution Soccer 2013;2012;Sports;0;0;0;0;0;0
Ragnaröck;2021;Sports;0;0;0;0;0;0
Slapshot Rebound;2020;Sports;0;0;0;0;0;0
Soccer Stars;2018;Sports;0;0;0;0;0;0
KARDS, The World War II Card Game;2019;Collectible Card Game;0;0;0;0;0;0
Pokémon TCG;1996;Collectible Card Game;0;0;0;0;0;0
Shardbound;2017;Collectible Card Game;0;0;0;0;0;0
Pac-man;1981;Puzzle Game;0;0;0;0;0;0
Apex Legends Mobile;2022;Battle Royale;0;0;0;0;0;0
Ark: Survival Of The Fittest;2017;Battle Royale;0;0;0;0;0;0
Rules Of Survival;2017;Battle Royale;0;0;0;0;0;0
Knockout City;2021;Third-Person Shooter;0;0;0;0;0;0
